##################################################################
#<4444444444444444444444444444444#K#OOOOOOOOOOOOOOOOOOOó44444444[#
#44444444444444444444444444444444#ô#44444444444444444444444444444#
#44444444444444444444444444444---#H#44444444444444444444444444444#
#44444444446666664444444444444-U-#4#44444444444444444444444444444#
#44444444446%W%W64444444444444---#4#44444444444################44#
#44444444446W%W%64444444444444444#4#4444444444?#11111111111111#44#
#44444444446%W%W64444444444444444#4#-###########/\//////\/////##-#
#44444444446666664444444444444444#4#-#**********/////\/\///\//\/-#
#44444444444444444444444444444444#4#-#**********\//\//////\/////-#
#--4444444444444444444444444444455555###########################-#
#K-444444444444444444444444444445T.T5#C-B--------B--------B------#
################################5.P.5#############################
##chamber#of#horror#4444444444445T.T5XXXXXXXXXXXXXXXXXXXXXXXXXX--#
####################44444444444455555XXXXXXXXXXXXXXXXXXXXXXXXXX-K#
#44444444444444444444444444444444#7###############################
#44444444444444444444444444444444#7#K-MMMMMMMXWWWWWWWWWWWWWWWWWWW#
#4444---444444444B444444444444444#7#--MMMMMMMX4444444444444444444#
#4444-K-4444444444444444444444444#7#MMMMMMMMMX4444444444444444444#
#4444---444444444444444###########7#MMMMMMMMMX4444444444444444444#
#4444444444444444444444#WWWWWE%%%#7#MMMMMMMMMX4444444444444444444#
#4444444444444444444444#WWWWW#####ô#MMMMMMMMMX444444444---4444444#
#4444###################-#####* !#ñ#MMMMMMMMMX444444444-U-4444444#
#|44488888888888888DDDDD-õDLL#  ò#K#MMMMMMMMMX444444444---444444"#
##################################################################