##################################################################
#~      YYYYYYYYYYYYYYYYYYYQMMMMMMMMMM*****MMMMMMMMMMMMMMMMXX##DL#
#   P   MMM<MMMMMMMMMMMMMMMMMMMMMMMMMM*****MMMMM"MMMTTMMMMMXX#D###
#       MMMMMMMMMMMMMMMMMMMMMMMMMMMMMM*****MMMMMMMMMTTMMMMMXXD####
#MM MMMMMMMMMMMMMMMMM?MMMMMMMMMMMMMMMMMMAMMMMMMMMMMMMMMMMMMXXXXXX#
#MM MMMMMMMMMMMMMMMMMMM A MMMMMMMMMMMMMMAMMMMMMMMMMMMMMMMMMXXXXXX#
#MM MMMM  A   MMMMMMM MMM MMMMMMMMMMMMMM         A      MMMMMMMMM#
#MM MMM MMMMM MMMMMMM MMM MMMMWWWMMMMMMMMMMMMMMMMMMMMMM    A     #
#MM MMMM MMMM MMMMMMMMMMMBMMMMWWWMMMMMMMMMMMMMMMMMMMMMM MMMMMMMMM#
#MM MMM MMMMMWMMMMMMM MMMMMMMMWWWMMMMMMMMMMMMMMMMMMMMMM MMMWWWMMM#
#WM MMMM MMMM MMMMMMM MMMMMMMMMMMMMMMM    MMA   MMMMMMM MMMWWWMMM#
#WM MMM MMMMM MMMMMMM MMMMMMMMMMMMMMMM MM MM MM MMMMMMM MMMMMMMMM#
#WM MMM MMMMM MMMMMMMMMMMMMMMMMMMMMMMM MM MM MM MMM|MMM A        #
#WMWMMM MMMMM A              A         MM    MM MMMMMMMM MMMMMMM #
#WMAMMM MMMMMMMMMMMMMMMMMMMMMMMMMMMMMMMMMMMMMMM  MMMMMMM MMMCMMM #
#WM MMM MMMMMMMMMMMMMMMMMMMMMMMMMMMMMMMMMMMMMMMM MMMMMMM MM MMMM #
#WM MMM     A                       A     W  MMMA    MMM M MMMMM #
#MM MMMMMMMMM MMMM MMMMMMMMMMMMMMMMMMMMMMMMM MMMMMMM MMM  MMMMMAM#
#MM MMMMMMMMM MMMM+MMMMMMMMMMMMMMMMMMMMMMMMM MMMMMMM MMMMMMMMM MM#
#MM   MMMMMMM!MMMMMMMMMMMWWWWWWWW@  A    MMM MMM     MMMMMMMM MMM#
#MMMMM  MMMMMMMMMMMMMMMMMMMMMMMMMMMM MMM MM  MMM MMMMMMMMMMM MMMM#
#MMMMMMM  MMMMMMMMM                  MMM MM MMMM MMMMMMMMMM MMMMM#
#MMMMMMMMMA MM  MM M@@@@@@@@@@@@@@@MMMMM M MMMMM A M M M M MMMA  #
#[MMMMMMMMMM  MM  MM@2222222222222@MMMMM A MMMMMMMM M M M MMMM  K#
##################################################################